they  : none-outerSubject	 (the Illinois police laboratory; : --)
his arrest  : none-outerSubject	 (Manuel;Manuel 's;the judge 's; : --)
pretrial challenge  : Court 	 (-- : --)
Fourth Amendment  : Court 	 (-- : --)
Fourth Amendment  : plurality 	 (-- : --)
they  : pretrial restraints 	 (pretrial restraints;the pretrial restraints in Albright; : --)
City  : it 	 (-- : The court;the Seventh Circuit;the court;)
applicable statute  : court 	 (-- : --)
Manuel  : Court 	 (Manuel;Manuel 's; : --)
such claims  : Court 	 (-- : --)
Amendment  : none-outerSubject	 (-- : --)
officer  : he 	 (-- : Albright;)
they  : none-outerSubject	 (pretrial deprivations of liberty;the deprivations at issue; : --)
Fourth Amendment  : plurality 	 (-- : --)
form  : complaint 	 (-- : --)
1983  : none-outerSubject	 (1983; : --)
such claim  : City 	 (-- : --)
Manuel  : City 	 (Manuel;Manuel 's;Manuel : --)
Manuel  : Circuit 	 (Manuel;Manuel 's; : --)
City  : it 	 (-- : the parties contest here .10 On remand)
Fourth Amendment  : none-outerSubject	 (-- : --)
Fourth claim  : Third 	 (-- : --)
he  : Manuel 	 (Manuel; : Manuel;)
appropriate analog  : Manuel 	 (-- : Manuel;)
Fourth standard  : it 	 (-- : subjective bad faith)
seizure  : claim 	 (-- : --)
favorable-termination element  : we 	 (-- : --)
claim  : none-outerSubject	 (-- : --)
he  : Manuel 	 (Manuel;Manuel 's; : Manuel;Manuel 's;)
Fourth Amendment  : answer 	 (-- : --)
moment  : Court 's opinion 	 (-- : --)
new claims  : it 	 (-- : The Court;the Court 's;)
Fourth Amendment  : Court 	 (-- : --)
Albright 's seizure  : I 	 (Albright;Albright 's; : --)
Fourth Amendment  : Court 	 (-- : --)
Fourth seizure  : statement 	 (-- : --)
Fourth Amendment  : which 	 (-- : --)
seizure  : none-outerSubject	 (-- : --)
arrest  : none-outerSubject	 (-- : --)
warrants  : Circuit 	 (-- : --)
detainee  : none-outerSubject	 (-- : --)
different kind  : none-outerSubject	 (-- : --)
malicious claim  : none-outerSubject	 (-- : --)
we  : Manuel 	 (the Seventh Circuit; : Manuel;Manuel 's;)
malicious prosecution  : circuits 	 (-- : --)
alse arrest  : Court 	 (-- : --)
none-innersubject : Court 	 (-- : --)
probable cause  : result 	 (-- : --)
Fourth Amendment  : Court 	 (-- : --)
